00000000000000000000
01111111111111110000
01111111111111110000
01011111111111110000
00111111111111110000
00111111111111110000
01111111111111110000
31111111111101111000
01111111111111101000
01111111111111100000
01110111111101110000
01110011111001110000
01111111111111110000
00001111111111110000
00000100011111111000
00000100001111111100
00000000011111100114
00000000011111000000
00000000011111000000
00000000000000000000